15,7,2,2,2
###############
#X# 2 ####  1##
# # #   ## #2 #
# #A###B##A####
# # ### ## ####
# 1 # 1     B@#
###############

x,y,fase,ix,iy
