15,7,3,2,2
###############
#X 1  ####    #
### #   ## ####
#2#A# #  # # @#
# # ### ## #B##
# 1 #        ##
###############

x,y,fase,ix,iy
