15,7,4,2,2
###############
#X 1  #### 1  #
### #   ## ####
#2#A#2#  # #A@#
# # ### ## #B##
# 1 #        ##
###############

x,y,fase,ix,iy
