26,12,6,2,2
##########################
#X#    1# ## A ###2#   ###
# # # ###    #   # # #   #
#   #A##  # #### # # ### #
##### ##     A #     ##  #
#      # ##### #B# ###  ##
# #### #     #   ####  ###
# ###  # #  #####  #  ####
#2##  ## # #####  #  #####
#2### #  #  ####A###B#####
###1B   ###      1 #  A @#
##########################