26,12,7,2,2
##########################
#X#    2# ## A ###1#   ###
# # # ###    #   #2# #   #
#   #B##  # #### # # ### #
##### ##     A #     ##  #
#      # #####C###1###  ##
# #### #     #@  ####  ###
# ###  # #  #####11#  ####
#1##  ## # ##### 1#  #####
#1### #  #  ####A###B#####
###2A   ###      1 #  A13#
##########################