12,15,9,2,14
############
# #2########
#    ## 111#
# ## #####A#
#1#     ## #
#   ###    #
#h###2# ####
##### #    #
#@# # #    #
#A##       #
#A#h##     #
#A  BB     #
#######    #
#X   1     #
############