15,7,1,2,2
###############
#X#   ####   ##
# # #   ## #  #
# #A### ## ####
# # ### ## ####
# 1 #        @#
###############

x,y,fase,ix,iy
