12,15,12,2,14
############
#@#2########
#D# 2##2111#
#    #####A#
#1#     ## #
#   ###    #
#h###2# ####
##### #   2#
#4A4D #  ###
#A###    #3#
# #h##   #B#
#AC BB     #
####### #B##
#X      #21#
############