14,9,14,2,8
##############
#2A    #441#@#
#A####  #D##C#
#   B4#      #
### ###   #  #
#11  2##A###A#
### #1#1 D1#1#
#X  #1#11#3#4#
##############
