16,12,16,2,6
################
#4B #   ##   ###
###   # ##A# ###
#11 ##  ##A#A###
### #D  ##A# A1#
#X  #4# #1 # ###
### #3# #1## 11#
##  ### # 1# 11#
#4D##   ## #   #
#4#@# # # 1# #A#
#4C #h#   ##h#2#
################
