14,13,17,9,6
#########     
##1 11#2#     
###     ####  
#2#        #  
#4# ######D#  
#   #  1X#A#  
# 2 #  ### #  
#     #@#  ###
# #B#A# ## #h#
#B#2#2#A#4   #
#h#3#2#B#### #
#######  C   #
.     ########
