15,7,5,2,2
###############
#X    #### A @#
# # #2  ##B####
# #B# # 2# # 2#
# # ### ##A# ##
# 1 #1B       #
###############

x,y,fase,ix,iy
