26,12,8,2,2
##########################
#X#2   1#1## A ###1#   ###
# # # ###    #   #2# #   #
#   #B##  # #### # # ### #
##### ##     A #     ##  #
#2     # #####D###1###  ##
#A#### #     #@  ####  ###
#1###  # #  #####11#  ####
#B##  ## # ##### 1#  #####
#3### #  #  ####A###B#####
###2A   ###      1 # 2C34#
##########################