12,15,1,2,14
############
# #2########
#    ##2111#
# ## #####A#
#1#     ## #
#   ###    #
#h###2# ####
##### #   2#
#@# # #  ###
#A##     #4#
#A#h##   #B#
#AD BB     #
####### h 1#
#X        h#
############