16,15,15,2,2
################
#X#1########1#4#
#    ##1111#1#3#
#A## #####A#1#3#
#A##1   ## # #C#
#B hA##        #
#3###2# ########
#####2# #2######
#@#2#B# #A######  
#A#1A # ########
#C###   ########
#BD     ########
####### ########
#h      ########
################

tx,ty,9,xi,fi
bauzinho
contar quantidade de reserts
fazer rank
tempo
* bomba