15,7,13,2,2
###############
#X#áéíóú#ç#ãõ##
# #êâôûîÂÊÔÎ ü#
# #AÊ äöï     #
# # ### ## ####
# 1 #   Ê    @#
###############

x,y,fase,ix,iy
